 #############
    ##########
### #   #   ## 
##  # # # # ##
### # ### # ##
#     #   # ##
# ##### # # ##
#       # #   
##############